1,2,3,4,5,,14,14,1,14,,6,19,,16
1,,12,5,,9,3,1,,15,3,14,19,1,5
13,19,10,1,17,6,,3,15,8,5,,17,,4
5,,19,13,6,,11,20,5,,12,11,6,16,5
19,7,,4,3,11,6,,7,3,17,6,,16,
,7,4,5,,6,7,2,3,,6,18,8,,20
8,19,,4,9,8,5,,4,3,,9,3,4,19
,6,2,3,,5,,16,5,11,6,,9,,1
15,18,9,,9,19,15,1,,18,20,19,1,17,
10,,19,9,8,,3,,2,,3,,13,6,10
19,19,13,6,,14,12,17,6,1,,19,,12,3
,17,6,12,13,6,,6,5,13,1,17,6,,11
14,6,,17,,8,16,3,,15,5,1,,17,6
8,18,17,6,18,,15,5,10,5,,17,20,3,
5,,2,,9,18,1,,7,,13,6,,12,10
